----------------------------------------------------------------
CaveMapGenerator
----------------------------------------------------------------
####################################################################################################
############################################################################  ######################
###########################################################  ###########       ###############  ####
#   #####################################################     #########        ####   ######    ####
#    ############    ##################################       #########   ##    ##    #####    #####
##         ######      ###############################      ###########   ###         #####    #####
##    #### ######       ##############################     ############   ####       #####     #####
##  ###### #######       #############################     ############   #######   #####       ####
########## #######       ##############################   #############    #############          ##
######  ##   ####       ################################ ##############     ############           #
#####                  ######################   ######## ##############      ##  ######            #
###                    #####################     ####### ###############          ###              #
###                    #####  ##############      ###### #################                  ####   #
#######        #####  #####     #############     ###### #################                 #########
########      ############      ##############    ###### #################        ###     ##########
########      ##########     #################    ###### #################     #######   ###########
#######       #########      #################     ##### ##################    #####################
######        #########       ################      #### ###################       #################
######        #########   ##  ################      ####                   ##      ######    #######
######        #########  #######################    ###################### ##     #######       ####
#######        #######   ########################    ##################### ##    ########        ###
########       #######    ####  #################    ##################### ##    ########        ###
########       #######     ##    ##  ############   ###################### ###   #########        ##
#######       #########               ###########   ###  ################# ####   ##########      ##
###          ###########              ###########   ##   ################# ####    ##########      #
##         #################  ##     ############         ####   ######### ###     ########## ###  #
#         #######################     ###########                 ####              ######### ######
#    #   ########################         #######                  ### #####         ######## ######
##  #### ###########################       ######   ##             ### ######   ##    ####### ######
######## ############################       #####  ####           ####       ######    ###### ######
######   ##############################     #####   ####       ############# #######    ##### ######
###### #################   #############    ####    ####     ############### #######    ##### ######
###### ###############      ############   ####     ####    ################ #######    ##### ######
######         ####          ####     #    ###      ####    ################ #######    ##### ######
############## ###                        ####       ###     ############### ##   ###  ##     ######
############## ##             ######    #######              ############### ##    ###### ##########
############## ##     ###    ########  ########               #######   #### ##     ##### ##########
##########     ##    ################ ##########                             ##      #### ##########
##########          ################  ############### ###               #### ##      #### ##########
##########         ################    ############## ########  ##      #### ##           ##########
##########         ######     ####     ##########     ################   ### ##      ###############
##########         #####       ###    ########### #####################  ###         ###############
##########         ####         ###  ############ #####################  ######          ###########
###  ####     #########         ################# ####################  ########         ###########
###   ##      ##########  ###    ################         ###########   ###########      ###########
###          ################     ####################### #######       ############    ############
####        #################     ####################### ####          #############  #############
#####      #################       ###################### ####         #############################
#######   #################         ####################    ###       ##############################
####### ##################           ##################      ######  ###############################
####### #####   #######                       #####          #######################################
####### ####    ######               ######## ####       ###########################################
#   ### ####     #####              ######### ####     #########################################  ##
#       ####     #####   #### #    ########## #####   ##########################################  ##
##      ####    ############# ##  #####  ##   ##### ############################################  ##
###     ####   ############## ########              ############################################  ##
####   ####### ############## ########         #### ###########################################    #
##### ######## ############   #########       ##### ##########################################     #
##### ######## ############ ############     ####   #######  #################################     #
##### ######## ######       #############   ####    ######   ##################################   ##
##### ######## ###### ##################### ####    ######  #######################    ######### ###
##### ######## ###### ##################### #####    ####   ######################      ######## ###
####                  ##################### ######          ######################      ######## ###
###   ########### ######################### #######          ######################     #######  ###
###   ########### ######################### ########         ######################     ######    ##
###   ##########      ##################### ##   ###         ######################      #####    ##
##    #######          ################          ###         ##########                   ####    ##
##   #######           ################ ###      ###          ######### ##########         ##    ###
##   #######           ################ ###     ####           ######## ##########         ##    ###
##  #######            ##############   ###########        #    ####### ##############      #     ##
##########            ########    ###    #########         #     ###### ###############           ##
##########           #######              #######                ###### ###############           ##
###########        ########     #####      #####                ####### ###############           ##
##############   #########     ######      ####                 ####### ################          ##
#######  #################     ######      ###                   ###### ########      ###        ###
######    #################     #####       ##                    ##### ########       ###      ####
##        #########  ########    #####      ##  ##                ##### #########      #############
##        #####       ########    #####     #######                #### ###    ####    #############
###       ####         #######     #####   ########                #### ###     ### ################
####      ####         #######     ####    ########                #### ###     ### ################
######   ######         ######    #####     ######      ##         #### ###     ### ################
######## ######   #      #####  #######     ####     #####                          ################
######## #####   ####          ##########   ###     ###### #####  ##########    ####################
######## ###      ####         ################    ####### ##################   ####################
######## ###      ####         ################   ######## #########  ######### ##############  ####
#######            ##         ############################ ########    ######## #############    ###
####### #####                 ############################ ########     ####### ############     ###
####### ######          ##    ############################     ####             ###########      ###
##  ### #######        ####  ############################# ### ###       ##################      ###
#    ## ########       ####   ######################  #### ###           ##################     ####
#       ###########    ####    ##############   ###        ###### ####    ##################   #####
##   ###############   ####    ##############          ########## #####    ######  ######### #######
###  ###############    ####    ############          ########### ######     ####    ####### #######
###  ##############     ####     #########         #############   ######     ##     ####### #######
###  ##############     ####     #########       ###############    #####            ####### #######
####################    ####     ###########    ################     #####                   #######
#####################   #####   #################################    ######         ####      ######
#################################################################    #######   ##  ######     ######
#################################################################   ########################  ######
####################################################################################################