####################################################################################################
#####################################    ###########################################################
#####################################     ##########################################################
################################          ####################################################  ####
################################ #####   #####################################################   ###
#######  #############   ####### ##### #################  ####################################   ###
#######  #####  #####    ####### ##### ################    ####################################  ###
##############           ####### ##### ################    ##################################### ###
##############                   ##### ################    ##################################### ###
##############            ############ #################    #################################### ###
####  ########            ############ ##################   ######  ########                     ###
###    #######            ##########   ##################   #####    ####### ################    ###
###    #######      ##    ##########   ##################   #####    ####### ################  #####
####   #######     ####   #########    ######   ########     #####  ######## #######################
####   #######    ################              ######        ############   #######################
###############   ###############      ##                      ##########    #######################
###############   ###############     ###                      ##########      #####################
###############   ###############    ####        ###          ############     #########     #######
###############   ####  ##########  ######      #####       ########  #####    #########     #######
###############  #####   #################       #####     #########  #####      #######     #######
##############   #####   #################       ######### ######### ######       #######   ########
############    ##########################       ######### ######### ######        #####    ########
###########    ############################       ######## ######### ######        #####    ##  ####
#########     #################################   ######## ######### #######      #######        ###
########      ##################################  ######## ######### #########  ##########       ###
#######       ############################################ ######### ######### ###############  ####
######           ######################################### ######### ######### ############### #####
###    #         #########################################        ## ######### ############### #####
##              #######  ##########################  ##########      ######### #############   #####
##             #######   #########################   ###########       ####### ############    #####
##          #########    #########################  #############       ###### #  #########    #####
##         ########       #######################################                  ########    #####
##        ########        ############    ##   ##################  ########          ######    #####
##       #########       ############           ########           ########          ######    #####
##      ###########  ################           ########   #####    ########    ############  ######
##    ##########    #################           ################      #######   ############ #######
##   #########      ########################     ##  ############     #######   ############ #######
##   ########       #########################         ##############  #######   #########    #######
##    #######       #########################         #######################  #######          ####
##    ######       #########################           ###################### #######           ####
###   #####       ##########################           ###################### #######      #    ####
###  ######    #################  ###########          ###################### ########    ###  #####
##  #######   #################     ##########          ##################### ########    ##########
#   #######   #################     ###########          #################### ########    ##########
#   #######    ####                 ############          ############     ##            ###########
##  #######    ###     ############ #############         ###########      #########    ############
###  #######   ###     ############ #############         ##########       #########   ####   ######
###  #############    ############# #############         #########        ######### ######    #####
####  ############    ############# ############         ########         ########## #######    ####
####       ######     ############# ###########    ###  ######            ########## #######     ###
#####       ####     ##############     ####      ############             ######### ######      ###
#####       ####    #####   ######       ###      #############    ###     ######### ######      ###
#####       ###    ######   ######               ############## #######     ######## #####      ####
######       ##    ######    #####      ####     ############## #######      #####             #####
#######      ##    ######      ####    #####      ############# ##########    ###    #####     #####
########     ###  ########      ####   #####        ########### ###########   ###     #####    #####
########     #############      ####   ######        ########   ##################    #####    #####
#########     #############    ####   ########        ######    ###################   #####    #####
##########    ##############   ###   ##########       ######     #######  ######### ########  ######
#####  ####    #############  ####   ###########       ######    #####       ###### ################
###     #####      ########  #####  ##############       ######   ###        ###### ################
##       #####     #######   #######################      ######   #         ###### ################
##       ###### ##########   #######################      ######             ###### ################
### ########### ##########  ###################          #######       ##    #####  ###########  ###
### ########### #########################               ########      ####  ######   #########   ###
### ########### ########################           ##############     ##### ######              ####
### ########### ########################          #################   #####          ##### ###  ####
### ########### ############################     ########################## ######  ###### #########
### ########    #############################     ######################### ######  ###### #########
### #####       ####################  #######     ######################### ############## #########
###             ##############   ##    ######      ######################## ############## #########
##   ##         #############          ######      ######################## ##############  ########
##   ##         #######  ####    #     #####      ######################### ##############   #######
##   ###        #######  #####  ###    ####      ########################## ##############    ######
##   ########  ########   ##########    ###     ########################### ###############   ######
##   ##################    #########    ###    ############################ #########  #####  ######
###  ##################    #########    ###   ############################# ########    ####  ######
######################      ##  #####  ###    ###    ###########   ######## #####        ###########
#####################            ########             #########      ######               ##########
######  #############            ########              ########      ###########          ##########
#####    #############           ########              #########     ############       ############
#####    ###############        #########             ##########    ##############     #############
#####    ################      ###########           ##########    ################   ##############
######  ######  ########   #  ######   ####         ###########    ################  ####         ##
#############    #######      ######   #####       #############  ################   ####          #
############     #######      ##############      ############## #################   #####         #
############      #####       ##############     ############### #################   #######      ##
############             ##  ###############    ################ ################    ########    ###
############            ###################    ################# ###############     #########  ####
############            ###################    ################# ##############      ########## ####
#############  ##      ####################     ###############   ############      ########### ####
####################  #############      ###     ############     ######  ####     ############   ##
#####   ##########################        ###                             #####    ############   ##
#####     #######################          ###  ############     ######    ####    ############   ##
#####      ######################           #################   #######     ##      #####   ###   ##
######     ######  ###############          ###########################              ####        ###
#######   ######    #################    ###############################                    ########
########  ######    ##################  #####################################       ################
#################  #################################################################################
####################################################################################################
