####################################################################################################
#####################################    ###########################################################
#####################################     ##################################      ##################
################################          ##################################      ############  ####
################################ #####   ###################################                     ###
#######  #############   ####### ##### #################  ##################      ############   ###
#######         #####    ####### ##### ################    #################      #############  ###
##############           ####### ##### ################    ##################################### ###
##############                   ##### ################    ##################################### ###
##############            ############ #################    #################################### ###
####  ########            ############ ##################   ######  ########                     ###
###    #######            ##########   ##################   #####    ####### ################    ###
###                 ##    ##########   ##################   #####    ####### ################  #####
####   #######     ####   #########    ######   ########      ####  ######## #######################
####   #######    ################              ######        ##### ######   #######################
###############   ###############      ##                      #### #####    #######################
###############   ###############     ###                      #### #####      ##########   ########
###############   ###############    ####        ###          ##### ######     #########     #######
###############   ####  ##########  ######      #####       #######   #####    #########     #######
###############          #################       #####     #########  #####      #######     #######
##############   #####   #################       ######### ######### ######       #######   ########
############    ##########################       ######### ######### ######        #####    ########
###########    ############################       ######## ######### ######        #####    ##  ####
#########     #################################   ######## ######### #######      #######        ###
########      ##################################  ######## ######### #########  ##########       ###
#######       ############################################ ######### ######### ###############  ####
######           ######################################### ######### ######### ############### #####
###              ##################################               ## ######### ############### #####
##              #######  #########################   ##########      ######### #############   #####
##             #######   #########################   ###########       ####### ############    #####
##          #########    #########################  #############       ###### #  #########    #####
##         ########       #######################################                  ########    #####
##        ########        ############    ##   ##################  ########          ######    #####
##       #########       ############           ########           ########          ######    #####
##      ###########  ################           ########   #####    ########    ############  ######
##    ##########    #################           ################      #######   ############ #######
##   #########      ########################     ##  ############     #######   ############ #######
##   ########       #########################         ##############  #######   #########    #######
##    #######       #########################         #######################  #######          ####
##    ######       #########################           ###################### #######           ####
###   #####       ##########################           ###################### #######      #    ####
###  ######    #################  ###########          ###################### ########    ###  #####
##  #######   #################     ##########          ##################### ########    ##########
#   #######   #################     ###########          #################### ########    ##########
#   #######    ####                 ############          ############                   ###########
##  #######    ###     ############ #############         ###########      #########    ############
###  #######   ###     ############ #############         ##########       #########   ####   ######
###  #############    ############# #############         #########        ######### ######    #####
####  ############    ############# ############         ########         ########## #######    ####
####       ######     ############# ###########    ###  ######            ########## #######     ###
#####       ####     ##############     ####      ############             ######### ######      ###
#####       ####    #####   ######       ###      #############    ###     ######### ######      ###
#####       ###    ######   ######               ############## #######     ######## #####      ####
######       ##    ######    #####      ####     ############## #######      #####             #####
#######      ##    ######      ####    #####      ############# ##########    ###    #####     #####
########     ###  ########      ####   #####        ########### ###########   ###     #####    #####
########     #############      ####   ######        ########   ##################    #####    #####
#########     #############    ####   ########        ######    ###################   #####    #####
##########    ##############   ###   ##########       ######     #######  ######### ########  ######
#####  ####    #############  ####   ###########       ######    #####       ###### ################
###     #####      ########  #####  ##############       ######   ###        ###### ################
##       #####     #######   #######################      ######   #         ###### ################
##       ###### ##########   #######################      ######             ###### ################
### ########### ##########  ###################          #######       ##    #####  ###########  ###
### ########### #########################               ########      ####  ######   #########   ###
### ########### ########################           ##############     ##### ######              ####
### ########### ########################          #################   #####          ##### ###  ####
### ########### ############################     ########################## ######  ###### #########
### ########    #############################     ######################### ######  ###### #########
### #####       ####################  #######     ######################### ############## #########
###             ##############   ##    ######      ######################## ############## #########
##   ##         #############          ######      ######################## ##############  ########
##   ##         #######  ####    #     #####      ######################### ##############   #######
##   ###        #######  #####  ###    ####      ########################## ##############    ######
##   ########  ########   ##########    ###     ########################### ###############   ######
##   ##################    #########    ###    ############################ #########  #####  ######
###  ##################    #########    ###   ############################# ########    ####  ######
######################      ##  #####  ###    ###    ###########   ######## #####        ###########
#####################            ########             #########      ######               ##########
######  #############            ########              ########      ###########          ##########
#####    #############                                 #########     ############       ############
#####    ###############        ###    ##             ##########    ##############     #############
#####    ################      #####   ###           ##########    ################   ##############
######          ########   #  ######   ####         ###########    ################  ####         ##
#############    #######      ######   #####       #############  ################   ####          #
############     #######      ####### ######      ############## #################   #####         #
############      #####       ##############     ############### #################   #######      ##
############             ##  ###############    ################ ################    ########    ###
############            ###################    ################# ###############     #########  ####
############            ###################    ################# ##############      ########## ####
#############  ##      ####################     ###############   ############      ########### ####
####################  #############      ###     ############     ######  ####     ############   ##
#####   ##########################                                        #####    ############   ##
#####     #######################          ###  ############     ######    ####    ############   ##
#####      ######################           #################   #######     ##      #####   ###   ##
######     ######  ##############           ###########################              ####        ###
#######                                  ###############################                    ########
########  ######    ################    #####################################       ################
#################  #################################################################################
####################################################################################################
